1111111111111111111111111111111
1000000P000000000000000000C0001
1000000000000000C0000000E000001
1111111111111111111111111111111