11111111111111111111
10000000000000000001
100010000000S0000001
10001000100000000001
11111111111111111111
