1111111111
1E0010C001
1000111001
1P00000001
1000000001
100C000001
1000000001
100000C001
1E00000001
0111111111