11111111111111111111
1E0000C0000000000001
100010000000P0000001
100010001000000C0001
100010001000000C0001
100010001000000C0001
10001000000000000001
10001000000000000001
10001000000000000001
10000000000000000001
10000000000000000001
10000000000000000001
10000000000000000001
10000000000000000001
10000000000000000001
10000000000000000001
10000000000000000001
10000000000000000001
10000000000000000001
11111111111111111111