111111111111111
1E0010C00000001
100010000000P01
100010001000001
100010001000001
100010001000001
10001000000C001
100010000000001
100010000000001
100000000000001
100000000000001
100000C00000001
100000000000001
10000000000C001
111111111111111