11111111111111111111
1E0000C0000000000001
100010000000P0000001
100010001000000C0001
11111111111111111111
