111111111111111111111
1E0010C00000000000001
100011100000000000001
1P0000000000000000001
100000000000000000001
100C00000000000000001
100000000000000000001
100000C00000000000001
1E0000000000000000001
100000000000000000001
100000000000000000001
100000000000000000001
100000000000000000001
100000000000000000001
100000000000000000001
100000000000000000001
100000000000000000001
100000000000000000001
100000000000000000001
100000000000000000001
111111111111111111111